1111111111
1E001100P1
1101C10111
11C0000111
1111111111